11 25
#########################
#....* o ..o..... ...o..#
#.@o.. .....*.o... .....#
#o  .......o.....o..o...#
#..o....o...o.o......oo.#
################.....o..#
#s.... ........*.o ...o.#
#.*...........  ..*.....#
#.......oo........o*.. .#
#.o.   *o.*..*..o....*..#
#########################
